11111111111111111111111111111111111111111111111111111111111111111111111111111111111111111111111111111111111
10P10C111111E0000000000000000000000000000000000000000000000000000000000000000000000000000000000000000000001
10000000111110000000000000000000000000000000000000000000000000000000000000000000000000000000000000000000001
101101100C0000000000000000000000000000000000000000000000000000000000000000000000000000000000000000000000001
11111111111111111111111111111111111111111111111111111111111111111111111111111111111111111111111111111111111
